1111111111111
1001000000001
1000011111001
10P011E000001
1000110C00001
1C00000C00C01
1111111111111