111111111111111111111111111111111111
100000P00000000000000000000000000001
101111100000000011100000000000000001
100111111111111111110111111111111111
110111111111111111110111111111111111
100000000100010101000001000100000001
1000000C0010001010100000100010000001
100000000001000101000A00000000000C01
100111111111001011110111100010000001
110111111111111111110111111111111111
110111111111111000000111111111111111
100111111100000011111111100000000001
100000000000000000000000000000000001
1000000000000C000000A000000000000001
10000000CA00000000000000000C00000111
110000000000000000000000000000000101
111111111111111111110111111111111111
111111111111111111110111111111111111
111111111111111111000111111111111111
111111111111111111011111111111111111
1000000000000000100000100000000A0001
10000000A000000010000010000000000001
1000000000010000000010000000000000E1
111111111111111111111111111111111111