1111111111111111111111111
1P0000000000000C000000001
1011111110111110111111101
1010000010000010000000101
1010111111111011111011101
1010100000000000000010101
1010111111111111111010101
101000000000C000000001011
1111011110111111111110111
10000100001000000C0000101
10111101111101111111001C1
1000000000000100000100101
1111111111110111111100101
1C000000000000000000000E1
1111111111111111111111111
