111111111111111111111111111111111111
100000000000000000000000000000000001
10011110000000001110000000000C000001
100100100000000010100000A00000000001
100100100011111010100000111110000001
100000000010001010100000100010000001
10000P000010001010100000100010000001
100000000010001010100000100010000001
100000000001000101000000000001000001
100111111111001011111111100010000001
100000000000000000000000000000000001
10000000000000000C000000000000000001
100111111100000011111111100000000001
10000000010000001000000010000000C001
100000000100000010000000100000000001
100000000100000010000000100000000001
100000000100000010000000100000A00001
100000000100000010000000100011111101
100000000000000000000000000000000001
1000000C00000000000C0000000000000001
100000000000000000000000000000000111
1000000000000000000A000000E000000101
111111111111111111111111111111111111
