111111111111111111111111111111111111
1P0000000000000000000000000001111111
100011111111111111111111011111000111
111011111110C000000001110111110C0111
1110000000000011111000001111110A0111
111111111110001111111110000000000111
111111111111111111111110111111110111
11111000000C000000001100011111110111
1111100C0111110000000000011111110111
111110000111111111111100000001110111
111111101111111111111100011101110111
11000000111000011111111111110111A111
110111101110A00111111111111101110111
1101111000000C0111111111110001110111
110011111110000000111111110001110111
110C11111111111111111111110C01110111
111111111111111111111111110000000111
100000111111100000000000000111110111
1110C011111110C011111111111111110111
1110A0000000000011111111111111110111
111000111111100000000001111111110111
111001111111111111110C00000000000A01
111000000111111111110000000000000C01
1111110C01111111111111111111111100E1
111111111111111111111111111111111111
