111111111111111111111111111111111111
100P0000000000CCCCCCCCCCC00000011111
10000000000000CCCCCCCCCCC00000000001
10000110000000CC11CCCCCCC00000000001
10000110000000CC11CCCCC1100000000001
10000000000000CCCCCCCCC1100000000001
10000000000000CCCCC11CCCC00000000001
10000000000000CCCCC11CCCC00000000001
10000000001100CCCCCCCCCCC00001100001
100000000011000000000000000001100001
100011000000000000000000000000000001
10001100000000000000000000000A000001
100000000011000000000000000000000001
100000A0001100000000110000000A000001
100000A0000000000000110000000A000001
10000000000000000000000000000A000001
10000011000000CCCC111CCCCC0001100001
10000011000000CCCC111CCCCC0001100001
10000000000000CCCCCCCCCCC00001100001
10000000000000CCCCCCCCCCC00000000001
10000000001100CCCCCCCCCCC00000000001
10000000001100CCCCCCCCCCC00000011111
10000000000000CCCCCCCCCCC000000000E1
11111000000000CCCCCCCCCCC00000011111
111111111111111111111111111111111111
